2
BG1.png
992 544
BG2.png
992 544
mygame2.txt
0
30 17
0 0 0 0 0 0 0 0 0 0 0 0 0 0 0 0 0 0 0 0 51 28 55 0 0 0 0 0 0 0
0 0 0 0 0 0 0 0 0 0 0 0 0 0 0 0 0 0 0 0 51 28 55 0 0 0 0 0 0 0
0 0 0 0 0 0 0 0 0 0 0 0 0 0 0 0 0 0 0 0 51 28 55 0 0 0 0 0 0 0
0 0 0 0 0 0 0 0 0 0 0 0 0 0 0 0 0 0 0 0 51 28 55 0 0 0 0 0 2 3
0 0 0 0 0 0 0 0 0 0 0 0 0 0 0 0 0 0 0 0 51 28 55 0 0 0 0 0 51 52
0 0 0 0 0 0 0 0 0 0 0 0 0 0 0 0 0 0 0 0 51 28 55 0 0 0 0 0 51 52
3 3 3 3 3 3 3 3 3 3 3 3 0 0 0 0 0 0 0 0 51 28 55 0 0 0 0 0 51 52
28 28 78 78 78 78 78 78 78 78 78 80 0 0 0 0 0 0 0 0 51 28 55 0 0 0 0 0 51 52
53 53 53 53 53 53 53 78 78 78 80 0 0 0 0 0 0 0 0 0 51 28 55 0 0 0 0 0 51 52
53 53 53 53 53 53 53 78 78 80 0 0 0 0 0 0 0 0 0 0 102 103 104 0 0 0 0 0 51 52
53 53 53 53 53 53 53 78 104 0 0 0 0 0 0 0 0 0 0 0 0 0 0 0 0 0 0 0 51 52
128 128 128 128 128 128 128 127 203 0 0 0 0 0 0 0 0 0 0 0 0 0 0 0 0 0 0 0 51 52
153 153 153 153 153 153 153 153 203 203 0 0 0 0 0 0 0 0 0 0 0 0 0 0 0 0 0 0 77 77
153 153 153 153 153 153 153 153 203 203 203 0 0 0 0 0 0 0 0 0 0 0 0 0 0 0 57 58 51 77
153 153 153 153 153 153 153 153 203 203 203 203 0 0 0 0 0 0 0 0 0 0 0 0 0 0 82 83 51 77
3 3 3 3 3 3 3 3 3 3 3 3 3 3 3 3 3 3 3 3 3 3 3 3 3 3 3 3 27 77
28 28 28 28 28 28 28 28 28 28 28 28 28 28 28 28 28 28 28 28 28 28 28 28 28 28 28 28 28 28
